{
    "tiles" : [[1, 1, 1, 1, 1, 1, 1, 1, 1],
               [1, 0, 0, 0, 0, 0, 0, 0, 1],
               [1, 0, 1, 1, 1, 1, 1, 0, 1],
               [1, 0, 1, 0, 0, 0, 1, 0, 1],
               [1, 0, 1, 0, 1, 0, 1, 0, 1],
               [1, 0, 1, 0, 0, 0, 1, 0, 1],
               [1, 0, 1, 1, 1, 1, 1, 0, 1],
               [1, 0, 0, 0, 0, 0, 0, 0, 1],
               [1, 1, 1, 1, 1, 1, 1, 1, 1]],
    
    "targetScore" : 1000,
    "time" : 30,
    "level" : "2",
}
